#########################
#.......................#
#.....##...............d#
#.......................#
#............##.........#
#.......................#
#...#..........d........#           ############################
#....#..................#           #........d..............d..#
#.....#.................#           #......#...................#
#.....##................#           #..........................#
#....##.................#           #..........#.........#.....#
#...##..................#           #..........................#
#.......................#           #..........................#
#..................##...#############..........................#
#..................##.........d.......................#dd......#
#..................##...#############....#.....................#
#.......................#			#..........................#
#....#..................#           ############################
#............#..........#
#..d.....................#
###################...###
                  #...#
###############   #...#
#.............#   #...#
#.............#   #...#
#.............#####...########
#............................#
##############################