############################################
#............##............###.....#.......#
#............##............##......#...#...#
#............##............##......#...#...#
#............##...........###......#...#...#
#............##....##....##........#...#...#
#............##....##....##........#...#...#
#............##....##...###....#####...#...#####
#............##........##......#.......#.......###
#............##........##......#.......#.........###
#######....#.........###.......#...###########.....######
      #....#........##.............#....................#
      #....#........##.............#....................#
#######....#.......#################....................#
...........#.......#....................................#
...........#.......#....................................#
.#####.#####.......#.......#########....................#
.#   #.#   #...............#       #....................#
.#   #.#   #...............#       #....................#
.#####.###########.........#       #....................#
...........................#       #....................#
############################       ######################